{
	"title": "level1",
	"sprite_key": [
		{ "x": 27, "y": 16 },
		{ "x": 28, "y": 16 },
		{ "x": 29, "y": 16 },
		{ "x": 30, "y": 16 },
		{ "x": 31, "y": 16 },
		{ "x": 32, "y": 16 },
		{ "x": 33, "y": 16 },
		{ "x": 34, "y": 16 },
		{ "x": 35, "y": 16 },
		{ "x": 36, "y": 16 },
		{ "x": 37, "y": 16 },
		{ "x": 38, "y": 16 },
		{ "x": 39, "y": 16 },
		{ "x": 40, "y": 16 }
	],
	"level": [
		[12,12,12,12,12,12,12,12,12,12,12,12,12,12,12,12,12,12,12,12],
		[12, 0, 0, 1, 0, 0, 0, 0, 0, 0, 0, 0, 0, 0, 0, 1, 0, 0, 0,12],
		[12, 0, 0, 0, 0, 0, 1, 0, 0, 1, 0, 0, 0, 0, 0, 0, 0, 0, 0,12],
		[12, 0, 1, 0, 0, 0, 0, 0, 0, 0, 0, 0, 0, 1, 0, 0, 1, 0, 0,12],
		[12, 0, 0, 0, 2, 3, 2, 2, 2, 3, 2, 2, 3, 2, 2, 3, 0, 0, 0,12],
		[12, 0, 0, 0, 2, 0, 0, 0, 0, 0, 0, 0, 0, 0, 0, 2, 0, 1, 0,12],
		[12, 0, 0, 0, 2, 0, 4, 4, 4, 5, 4, 4, 4, 4, 0, 2, 0, 0, 0,12],
		[12, 0, 1, 0, 3, 0, 4, 5, 4, 4, 4, 5, 4, 4, 0, 3, 1, 0, 0,12],
		[12, 0, 0, 0, 2, 0, 4, 4, 4, 4, 4, 4, 5, 4, 0, 2, 0, 0, 0,12],
		[12, 1, 0, 0, 2, 0, 0, 0, 0, 0, 0, 0, 0, 0, 0, 2, 0, 0, 1,12],
		[12, 0, 0, 0, 2, 3, 2, 3, 2, 2, 2, 3, 2, 2, 2, 3, 0, 0, 0,12],
		[12, 0, 0, 1, 0, 0, 0, 1, 0, 0, 0, 0, 0, 1, 0, 0, 0, 0, 0,12],
		[12, 0, 0, 0, 0, 1, 0, 0, 0, 0, 0, 0, 0, 0, 0, 0, 0, 1, 0,12],
		[12, 0, 0, 0, 0, 0, 0, 0, 0, 0, 0, 1, 0, 0, 0, 0, 0, 0, 0,12],
		[12,12,12,12,12,12,12,12,12,12,12,12,12,12,12,12,12,12,12,12]
	]
}
